8 8 15 15
0 0 0 0 -1 -1 0 0
S -1 -1 -1 -1 0 0 0
0 -1 -1 0 0 0 -1 0
0 -1 0 -1 -1 0 -1 0
0 -1 0 -1 G 0 -1 0
0 -1 0 -1 -1 -1 -1 0
0 -1 0 0 0 0 -1 0
0 0 0 -1 -1 -1 -1 0