10 10 26 26
0 0 0 -1 0 0 0 0 0 0
0 S0 0 -1 0 G0 0 -1 0 0
0 0 0 -1 0 0 0 -1 0 0
0 -1 -1 -1 -1 -1 0 -1 0 0
0 0 0 0 -1 0 0 0 0 0
0 0 0 -1 0 -1 0 0 -1 0
0 -1 0 0 5 0 -1 0 0 0
0 0 0 0 -1 0 0 0 0 0
0 -1 0 0 2 0 -1 0 0 0
0 0 0 0 0 0 0 0 0 0
