8 8 20 20
0 0 0 8 0 0 0 0
0 -1 -1 -1 -1 -1 0 0
0 S0 0 5 0 -1 0 G0
0 0 0 -1 0 -1 0 0
0 0 -1 -1 0 -1 0 0
0 0 0 4 0 0 0 0
0 -1 -1 -1 -1 -1 -1 0
0 0 0 0 0 0 0 0
