10 10 30 30
0 0 0 0 -1 0 0 0 0 0
0 S0 0 0 2 0 0 -1 0 0
0 0 0 0 -1 0 0 -1 0 0
0 -1 -1 -1 -1 -1 0 -1 0 0
25 0 0 8 0 0 0 0 0 0
0 0 0 -1 0 -1 0 0 -1 0
0 -1 0 0 9 0 -1 0 0 0
0 0 0 0 -1 0 0 0 0 0
0 -1 0 0 0 2 -1 0 0 0
G0 0 0 0 0 -1 0 0 0 0
