12 12 25 25
0 0 0 0 -1 -1 0 0 0 0 0 0
0 S -1 0 0 0 0 -1 0 0 -1 0
0 0 -1 0 -1 0 0 -1 -1 0 -1 0
-1 0 -1 0 -1 0 -1 0 0 0 -1 0
0 0 -1 0 -1 0 -1 0 -1 -1 -1 0
0 -1 -1 0 -1 0 -1 0 0 0 0 0
0 0 0 0 -1 0 -1 -1 -1 -1 0 -1
-1 -1 -1 0 -1 0 0 0 0 -1 0 0
0 0 -1 0 -1 -1 -1 -1 0 -1 0 -1
0 0 -1 0 0 0 0 -1 0 -1 0 0
-1 0 -1 -1 -1 -1 0 -1 0 -1 G 0
0 0 0 0 0 0 0 -1 0 0 0 0