10 10 50 10
S0 0 0 0 -1 -1 0 0 0 0
-1 -1 -1 2 3 4 -1 -1 -1 -1
0 0 0 0 -1 0 0 0 0 0
0 -1 1 F1 -1 F2 -1 -1 -1 0
0 2 -1 0 0 0 -1 3 0 0
0 -1 3 0 0 0 -1 0 4 0
0 0 0 0 0 0 0 0 0 0
-1 -1 -1 4 -1 -1 2 -1 -1 -1
0 0 0 F3 0 0 0 0 0 G0
0 0 0 0 0 0 0 0 0 0
